"Jahr";"Erdgas";"Flüssiggas";"Heizöl";"Holzpellets";"Strom";"Wärme";"Gesamt"
2002;15;0;2;0;0;5;22
2003;22;0;15;0;0;5;42
2004;27;0;26;0;0;20;73
2005;88;0;45;0;0;36;169
2006;85;0;59;0;0;56;200
2007;50;1;43;0;0;33;127
2008;49;2;35;0;0;37;123
2009;54;1;46;0;0;75;176
2010;40;0;22;0;0;35;97
2011;35;1;27;0;0;41;104
2012;33;0;20;2;0;46;101
2013;12;0;12;5;1;35;65
2014;17;0;13;1;1;13;45
2015;24;0;4;0;0;11;39
2016;22;0;4;0;0;11;37
2017;54;1;5;0;7;16;83
2018;24;0;2;0;1;19;46
