"Jahr";"Erdgas";"Flüssiggas";"Heizöl";"Holzpellets";"Strom";"Wärme";"Gesamt"
2002;51;0;39;0;0;0;90
2003;125;0;89;0;0;8;222
2004;226;0;129;0;0;24;379
2005;349;1;216;0;0;43;609
2006;427;1;242;0;1;65;736
2007;302;2;191;0;0;28;523
2008;184;1;104;0;0;17;306
2009;154;1;93;0;0;39;287
2010;165;0;104;0;5;31;305
2011;147;0;88;3;8;29;275
2012;132;4;83;1;5;17;242
2013;103;2;49;5;4;17;180
2014;91;4;64;1;5;11;176
2015;99;1;68;1;6;14;189
2016;77;0;70;2;4;13;166
2017;72;0;57;1;6;14;150
2018;30;0;20;0;8;13;71
2019;0;0;0;0;0;1;1
